NO textures/no.xpm
SO textures/so.xpm
WE textures/we.xpm
EA textures/ea.xpm

F 29,75,9
C 116,179,255

00111111111111111111111110
 1000000000000000000000001
 1001000000000000000000001
 100010000000000000000000111111111
 100000000000000000000000000000001
 1000S0000000000001110111111111111
 11110111111111011100000010001
 11110111111111011101010010001
 11000000110101011100000010001
 10000000000000001100000010001
 10000000000000001101010010001
 110000011101010111110111100111
 11110111 1110101 101111010001
 11110111 1111111 111111111111
    101
    101
    101
    101
    101
    111

   
