NO no.xpm
SO so.xpm
WE we.xpm
EA ea.xpm

F 220,100,0
C 225,30,0

1111111111111111111111111
1000000000000000000000001
1000000000000000000000001
100000000000000000000000111111111
100000000000000000000000000000001
1000S0000011000001110111111111111
11110111111111011100000010001
11110111111111011101010010001
11000000110101011100000010001
10000000000000001100000010001
10000000000000001101010010001
110000011101010111110111100111
11110111 1110101 101111010001
11110111 1111111 111111111111
   101
   101
   101
   101
   101
   111

   