NO no.xpm
EA ea.xpm
WE we.xpm
SO so.xpm

F 255,0,0
C 0,255,0

111111111111111111111
100000000000000000001
100000000000000000001
100000000000000000001
100000000000000000001
100000000000000000001
10000000000N000000001
100000000000000000001
100000000000000000001
111111111111111111111